Junana: Jane.
Jursella, Jursola:
Justina: Justine.
K.
Kananus: Kynan.
Kanaucus: Cynog.
Karadocus: Caradog.
Kenanus: Cianan.
Kenewricus: Cynvrig, Kenric.
Kenoldus:
Kenulmus: Kenelm.
Killanus: Killeen, Kylian.
L.
Laderena:
Laetitia: Lettice.
Lancilottus: Lancelot.
Landebertus: Lambert.
Laua:
Laudus: Lo.
Laurentius: Lawrence.
Laureta:
Lecia: Lettice (?).
Leffeda:
Legardis:
Lena: Short for Alina or Euelina.
Leobinus: Lubin.
Leodgardus, Leodegarius: Ledger, Leger.
Leonellus: Lionel.
Leouegarus: Leofgar.
Leouenothus: Leofnoth.
Lesquena:
Lessa:
Letia: Lettice (?).
Letitia: Lettice.
Letuaria:
Leubatius: Leubasse.
Leuca:
Leodocus: Llawddog, Lleuddad.
Leuelinus: Llywelyn.
Leuericus: Leofric.
Leygarda:
Licinius: Lezin.
Licoricia: See Lyquiricia.
Lieba:
Lietphardus: Lifard.
Ligerius: Leger.
Liniota:
Lionhardus: Leonard.
Lipwinus: Lebwin.
Lorencia:
Loreta:
Loueda: Loveday, Lowday (f.).
Luanus: Lugid.
Lucas: Luke.
10

