Goscelinus: Jocelin.
Gosfridus: Geoffrey.
Gouda:
Grahamus: Graham.
Gralandus:
Granta: (Irish).
Gratia: Grace.
Griffinus: Griffin, Griffith.
Grimolfus: Grimulf.
Gualaricus: Velery.
Gualterus: Walter.
Guarinus: Warin.
Gudila: Goule.
Guendoloena, Guenliana: Gwenllian.
Guichardus: Wicher.
Guido: Guy.
Guillelmus, Gulielmus: William.
Guinailus: Guenau.
Gunnilda: Gunhild.
Gwendoloena: Gwenllian.
H.
Habet:
Hadewisa:
Haluatheus:
Hamo: Hamon, Ham.
Haraldus: Harold.
Hasculfus: Hascoil, Hasculf.
Hawisia: Hawis, Hayes, Hawes.
Heilewisa: Helewis.
Heleca:
Helena: Helen.
Helewisa: Helewis, Helwis.
Helewisus:
Helisanta:
Heltus: Helt.
Helyas: Ellis.
Hendricus, Henricus: Henry.
Hereweccus: Hervey.
Hermelandus: Erbland.
Hersius:
Herueius, Heruicius, Heruicus: Hervey.
Hieremias: Jeremiah.
Hieronymus: Jerome.
Hilaria: Hillary.
Hilarius: Hillary.
Hodierna:
Hoelus: Howell.
Honesta: Honesty.
Honoria: Honour.
Hosto:
Huelina:
Huga:
Hugo: Hugh.
Humelina:
Humetta:
Humfredus: Humfrey.
Hunniua: Hunneve.
8

