Lucasius: Luke, Lucas.
Lucia: Lucy.
Ludouicus: Ludwyke, Lewis.
Luelinus: Llywelyn.
Lupentius: Louvent.
Lupillo:
Lupus: Leu.
Lyquiricia: (Jewish).
M.
Mabilia, Mabilla: Mabel.
Macarius: Macary.
Machutus: Mawe.
Macia: Same as Mascia.
Madelgarius: Mauger.
Madelgisilus: Maguil.
Madocus: Madog.
Maggota: Magote.
Magnobudus: Mainbeu.
Magonius: Mahon.
Maidocus: Madog.
Mailgo: Maelgwm.
Makinus, Makina:
Malachias: Malachy.
Malculinus: Malcolm.
Malla:
Manautus: Menauld.
Mannicus: Mannig.
Manserus, Manserius: Manasser.
Marculfus: Marculf, Marcoul.
Marcus: Mark.
Margareta: Margaret.
Margeria: Margery.
Margota: Margot.
Maria: Mary.
Mariana: Marion.
Mariota: Mariot.
Marta: Martha.
Martia:
Martius: Mars.
Mascia:
Mascilia:
Mascria:
Mathias: Macy, Mazy
Mathila:
Matilda, Matildis, Matillis: Matilda, Maud, Malkin
Matthaeus: Matthew, Mawe in Yorkshire.
Matthias: Matthias.
Mauditus: Mawe.
Mauricius: Maurice, Morris, Merrick
Maurilius: Maurille.
Maya: May.
Mazelina:
Meilerius: Meilyr.
Meliora:
Memmius: Menge.
Menautus: Menauld.
Mercia: Mercy.
11

