Fluria:
Falcho: Fulk.
Foulconus: Fulk.
Frambaldus: Frambourd.
Francisca: Frances.
Franciscus: Francis.
Francus: Frank.
Frarius: (Jewish).
Frethesauta: Frideswide (?).
Fridericus: Frederick.
Fulco: Fulk.
Fullanus: Foignan.
Fulqueyus: Fulk, Fulcui.
Furseus: Fursey, Furce.
G.
Galfridus: Geoffrey.
Galia:
Galiena:
Galterus: Walter.
Galwanus: Gawain.
Garinus: Warin.
Garsiana:
Gartenetus: Gratnach, Gratney.
Gaufridus: Geoffrey.
Gaugericus: Geri, Gerz.
Gena:
Genesicus: Genes.
Genofeua: Genevieve, Jenofeffe, Jenefefe.
Genulfus: Genou.
Gerardus: Gerard.
Gerinus:
Germanus: Germain, Garmon.
Geroldus: Gerald.
Geruasius: Gervase.
Geua: Eve.
Gilebertus: Gilbert.
Gilemota: Wilmot.
Giliana:
Gilo: Gilly.
Gineura: Guenever, Wenhover.
Gislibertus: Gilbert.
Gislenus: Guislan.
Gladusa: Gladys.
Glicerius: Lizier.
Goda:
Godefridus: Godfrey.
Godeheuta:
Godelacius: Guthlac.
Godeleua:
Godescallus: Godescalde.
Godreda:
Godusa:
Goisfridus: Geoffrey.
Gondulfus: Goudon.
Gonnilda: Gunhild.
Gorreia: Another form of Godreda.
Goscelina: Joscelyne.
7

