Dionisia: See Denisia.
Dionysius: Denis.
Diota: Dyot.
Direta:
Dominicus: Dominick, Sunday.
Domuelus: Dogmael.
Donatus: Donagh, Donell.
Dorothea: Dorothy, Dolly.
Dorotheus: Dorothe.
Dousa: Douce.
Drago: Drieu, Drue, Drew.
Droco, Drogo: Drieu, Drue, Drew.
Druco: Drue.
Druetta:
Drugan: Drue.
Dubricius: Dyfrig, Devereux.
Dulcia, Dulicia: Douce.
Dulcibella: Dowsabell.
Dunechanus: Duncan.
Duuenaldus: Donnell, Donald.
Duuianus: Dyfan.
E.
Eadburga: Edburrow.
Eadgitha: Edith.
Eadmundus: Edmund.
Eadwardus: Edward.
Ebba, Sancta: St. Tabb.
Eberhardus: Erhard.
Ebrulfus: Evroul.
Ebulo: Eble, Eubold, Euball.
Eda:
Edania: Edene.
Edekina:
Edelota: Ydelot.
Edenuettus: Edneved.
Ederodus:
Edina:
Editha: Editha, Edy.
Edonia: Edoyne.
Edusa, Edussa:
Egelwinus: Ailwin.
Egidia: Giles, Gille.
Egidius: Giles.
Elena: Ellen.
Elfleda: Efflet.
Elfredus: Alfred.
Elianora: Eleanor.
Elias: Ellis.
Eliphius: Elof.
Elisabetha: Elizabeth, Isabella.
Elisanta:
Elizeus, Ellicius: Elys, Ellis.
Elmua:
Eltutus: Illtyd.
Elyas: Ellis.
Emelina: Emily.
Emericus: Aymer, Emery.
5

