Hychecosus:
I.
Ibbota: Ebote.
Ibria:
Idaburga: Edburge.
Idonia: Edene, Idoigne, Ideyn, Iden.
Ignauus: Ednevet.
Ilaria: See Hilaria.
Iltutus: Illtyd.
Imania: Emma.
Ingelata:
Ingeleramus, Ingelramus, Ingeramus, Ingerramus: Ingram.
Ingelesia:
Ingoldus:
Ingulfus: Ingolf.
Ingusia:
Ionius: Yon.
Irilda:
Isabella: Isabel, Elizabeth.
Isamaya: Ismay.
Isilia:
Ismania: Emma:
Isolda, Isota: Iseult, Isoude, Isote.
Iterius:
Iuo: Ives.
J.
Jacobus: Jacob, James.
Jacomyna: Jacquemine.
Jacquetta: Jackett.
Janbertus: Janbryht.
Janeta: Janet, Janekin.
Jerberga:
Jereuerdus, Jeruerdus: Jorwerth.
Jestinus: Jestin.
Joceus: Joice.
Jocosa: Joice.
Jodoca: Joice.
Jodocus: Joice.
Johanna: Joan, Jane.
Johannes: John.
Joldanus:
Jordana:
Joscelinus: Gezelin.
Josias: Josiah.
Jouetta: See Juetta.
Joylanus:
Judas: Jude.
Judocus: Josse.
Juetta: Jowet, Ivote.
Juetus: Jowett.
Juisa:
Julia: Syly (Irish).
Juliana: Juliane, Gillian.
Julita: Juliet.
9

