matinellum: breakfast.
matracia, matracium: a mattress; quiet.
matria: a pantry.
matricula: a list; a register.
matrimonium: marriage; inheritance descending by marriage.
matrina: a godmother.
matutini: lauds, in the Rule of St. Benedict.
matutinale: a book of lauds.
matutinellum: breakfast.
maupigyrnum: a sort of pottage.
maviscus: a thrush (Turdus musicus).
maxima: an axiom; a maxim.
maximus senex: oldest.
mazenarius: a keeper of mazers.
mazonarius: a mason.
meandrum: a rubbish hole.
meanialis. See menialis.
meatim: in my own way.
medaria: a place for making or stowing mead.
medarius: a mead maker, or seller; an official in charge of the medary in a convent.
mederia: a house where mead is sold.
mediamnis: a dyke; a canal.
medianetum: arbitration.
meda: mead.
medicus digitus: the third finger.
medie manus, homo: a man of low rank.
medietas: mesnalty, the right of the mesne lord.
meditentum: the cap of a flail.
meditullium: middle.
medius: mean; mesne.
medlea, medieta, medletum: a fray; a medley.
medo: mead.
megadomesticus: a chief officer of the household, a major domo.
megarus: mackerel (scomber scombrus).
megucarius: a white tawyer, a leather dresser.
meida: madder.
meimmatus: maimed.
mela: a measure of corn and cheese (Scotch).
melleta. See medlea.
mellibrodium: bracket or bragwort, a drink flavoured with honey and spice.
mellitarius: a beekeeper.
melotus: a badger (meles taxus).
memorandorium: a catalogue.
memorator: a remembrancer.
memprisa. See manucaptio.
menagium: a family.
mencia. Perhaps an error for meneia.
meneia: appearance; obeisance (?).
menestrallus: an artisan; a minstrel.
menetum: a wooden horn.
menialis: menial. From moenia.
meniare: to wall.
mensacula: a carving kinfe.
mensura: a bushel; standard measure; a candle of the length of or perhaps image in wax of a sick person or limb
sent to a shrine.
mensurare: to measure for the purpose mentioned above.
menusa: reeds, rushes (?).
mera: a marsh; a mere; unpressed wine. (Fr. m√®re goutte.)
merarius: a midday meal.
merca. See marca.
87

