convitiare: to rail at.
cooperlectorium: a coverlet.
coopero. See coprones.
coopertia, coopertio: bark and broken wood of felled trees.
coopertor: a tiler; a thatcher.
coopertorium: a coverlet; a roof; a cuirass.
coopertum: covert.
coopertura: a covert; a cuirass; coverture, the condition of a married woman; thatch.
coopertus equus: a barded horse.
coopicium: coppice.
copa: a cop of corn, "sc. xx. garbae" (Sussex); of peas, 15 or 16 sheaves.
coparcenaria: comparcenary.
coparticeps: a coparcener.
copecia: coppice.
copero. See coprones.
coperosa: copperas.
copertorium. See coopertorium.
copertum: cover for game.
cophinus: a coffer; a coffin.
copia: a copy.
copiare: to copy.
copicia: a coppice.
copla: a couple.
copo: twigs.
coppa. See copa.
coppatus: coppice.
coprones: twigs.
copucium: a coppice.
copula: a couple for hounds; a joist; a tiebeam.
coqua. See coga.
coquarius: a cook.
coquinarius: the kitchen steward in a monastery.
coragium: a tribute of certain measures (corus) of corn; or perhaps the same as cornagium.
coralius: a currier.
corarius: a currier.
corballum, corbella: a basket.
corbanus: a rural dean (plebanus) in Ireland.
corbellus: a corbel, a projecting piece of timber to support a weight.
corbio: a basket maker.
corbis: a hive.
corbona: a priest's treasury or strong box.
corda: a cord; a measure of land, 22 feet; a cord of wood, 8 or 10 feet by 4 feet by 4 feet.
cordarius: a rope maker.
cordebanarius, corduanerius: a cordwainer.
cordelatus: corded.
corderius: a rope maker.
cordewana, corduana: cordwain, Cordovan leather.
corduanarius: a cordwainer.
cordula: a string.
corerius: a courier.
coretes: weirs. (Welsh, cored.)
corgigatorium: a churn.
corigia, corigium. See corrigia.
coriletum: a hazel copse.
corluvus: a curlew (numenius arquata).
cormusa. See cornamusa.
cornagium: cornage, horngeld, payment for right to graze cattle on moor or common; a rent or tax paid on oxen.
cornamusa: a cornemuse, a Cornish bagpipe.
cornare: to blow a horn.
cornarius: a horner; a horn blower.
38

