gemala: a hinge.
gemellus: a clasp with similar ends, or double brooch. O.E. gemewe.
gemotum: an assembly.
genealis: native.
generale: the commons of a monk.
generosa: a gentlewoman.
generosus: a gentleman.
geneta: a genet, a beast of the weasel tribe, used for fur (genetta vulgaris).
genimen: an offshoot.
genoboda: a moustache.
gens: often used for an army.
genuscissio: hocking or hambling dogs by cutting the sinew of the hind leg.
geola, &c. See gaola, &c.
gerarchia: used for hierarchia.
gerca, gercia, gercis: a ewe lamb.
gerentarius: an officer in a convent, probably a friary, who was not compelled to reside therein (granatarius?).
gerlanda: a garland.
gernarium: a granary.
gersa: starch.
gersuma: a fine; a reward; an earnest. O.E. "gryssume."
gerulus: a packhorse.
gerusa: a goad.
gesa: a gisarme. See gisarma.
gesta: (pl.) deeds; a history.
gesta, gestum: yeast; food.
gestrum: a jesterne or jestorne, a sleeveless jacket of scale armour.
getti: a hawk's jesses.
getticium: a jetty.
gewineda: an assembly.
ghestum: food; a meal given to a guest. See gistum.
guialda, gyalda: a guildhall.
gifra: cypher.
gifta: a stream; sometimes used for gista.
giga: a cittern.
gignasium, i.e., gymnasium.
gihalda: a guildhall.
gilda: a fraternity, a guild.
gilda aula: a guildhall.
gildare. See geldare.
gildatio. See geldatio.
gildaula, gildeaula, gildhalla: a guildhall.
gildhalla Teutonicorum: the Steelyard, or company of Easterling merchants.
gilfalco: a gerfalcon (fulco Islandicus).
gilla, gillus: a mug.
gillagium: tax paid on wine sold by retail.
gilofera: clover or gillyflower.
gimphus. See gumfus.
gingibrattum: ginger.
gipo: a doublet (pourpoint).
gipsura: pargeting.
girgillare: to wind up.
girgillus: a reel with a handle for winding thread.
girivagus: wandering.
giro: an apron, a skirt.
gisarma: a gisarme, a weapon resembling a halberd, having a spear point, with a small axe at the foot of the
point, and sometimes a spike on the opposite side; but in Matthew Paris (Rolls Ed. I. 470) the phrase occurs,
"sica, id est, gisarme."
gista: a joist. See also gistum.
gistare: to furnish with joists; to recline on a litter.
gistarius: borne on a litter.
63

