vilnetum. See vicinetum.
vina: a fin.
vinagium: rent paid in wine.
vinaria: a vintry.
vinegrum: vinegar.
vinetria: a vintry.
vinitarius: a vintner; the custodian of the wine in a convent.
vinitor: a vintner.
vinna: a drag-net.
vintarius, vintenarius: a vintner; a commander of twenty soldiers.
virbius: twice married.
virga: a yard; a wand; the verge, the compass of the king's court.
virgarium: an osier bed.
virgarius. See virgatarius.
virgastrum: an osier bed.
virgata: a yard-land, or verge, a quarter of a hide, varying from 12 to 40 acres; the verge.
virgatorius: originally a holder of a virgate or yard-land, but used for all small holders of land.
virgator: a verger.
virgeus: striped, brindled.
virgiferens: a verger.
virgultarius: an orcharder.
viridariae dies: days for surveying the viridaria in a forest.
viridarium: a clearing in a forest; a garden.
viridarius: a verderer, a forest officer; a hayward.
viride: vert or greenhue, trees, &c. in a forest; the right to cut green wood.
viridere: to scour a river or ditch.
viridis: sometimes used for varium, vair.
viridium, virificum: varnish.
viro: a boatman.
visitor: a vejour.
visnetum. See vicinetum.
visor: an inspector.
vispilio: a nocturnal robber.
vista: an interview.
visus: a view.
vitellarius: a victualler.
vitellium: caudle.
vitillarius: a victualler.
vitreare, vitriare: to glaze.
vitriatio: glazing.
vitriatus: glazed.
vitulamen: a graft.
vitulare: to calve.
vitulinium: vellum.
vivarium: a park; a fishpond. O.E. vever.
viverra: a ferret.
vobisare: to address in the plural.
vola: the hollow of the hand; a handful.
volatus: falconry.
volsura: vaulting.
volta: a vault.
volticium: an arch.
volupare: to roll up (volutare).
volutus: a vault.
vosare: to address in the plural.
vota: a drain; a vault.
vouta: a vault.
vulgariter: in English.
vulpericia canis: a foxhound.
141

