pelliris: a palet, a headpiece of cuir bouilli.
pellura: fur.
pellus: a shovel; a peel.
pelota, pellota: a ball; the ball of the foot.
pelum. See pela.
penalitas: penalty.
pendicia: appurtenances.
pendicula: a plumb-line.
pendiculum: a timber arch over a doorway.
pendulus: a pendant jewel.
penerarius: an ensign-bearer.
penitenciaria: penitentiaryship.
penitenciarius: a penancer.
penitimus: inmost.
penitior: inner.
pennarium: a penner.
pennula. See penula.
pennum: a pennon.
pensa: a wey. See waga.
pensionarius: liable to payment.
pensum: a weight.
pentecostalia: Whitsuntide offerings, or a payment in lieu of them.
Pentecoste: Whit Sunday.
penticium: a pentice or penthouse.
penucella: a pensell or penoncell, a small banner.
penula: a hood.
penularius: a maker of hoods; a parmenter.
penulatus: hooded; furred.
pera: a purse; a bag; a pier.
peracula: a little bag or purse.
perambulata, perambulatio: survey; a walk in a forest (?).
perambulum: a walk; an alley.
perapsis: a platter.
peraria. See petraria.
perca: a perch of land. See pertica.
percaminarius: a seller of parchment.
percaptura: stakes set in a river for catching fish.
percata: a perch. See pertica.
percella. See parcella.
perchia: a perch (perca fluviatilis); a perch or pole. See pertica.
percursum: pursuit; the right of following game beyond one's own bounds.
perdica: used for pertica.
perdona: pardon; discharge; remission.
perdonare: to pardon.
perdonatio: pardon.
perdonista: a pardoner, an official from whom pardons can be obtained.
perdricarius: a man employed in taking partridges.
perecia: a piece, a fragment.
peregrinatio: a pilgramage.
peregrinus: a pilgrim.
perempnis: used for perennis.
perendinare: to delay; to remain, to reside; to redouble.
perequare: to level.
performare: to perform.
pergamena: parchment.
pergamenarius: a parchment maker.
pergulum: a lodge; a pound.
perhendinare. See perendinare.
peribolus: a circuit; a compass; a gallery.
peridota: a peridot, a gem, colour green.
100

