falerator: a sumpter man.
falescere: to cease; to fail.
falesia: a rock, a cliff.
falinga: a cloak or jacket, used in Ireland (falding?).
falla, fallum: a measure of land; tin; a fault.
fallire: to fail.
falmotum: a folkmote.
falsare: to deceive; to falsify; to forge.
falsarius, falsonarius: a forger.
falsator: a forger.
falsitas: forgery.
falsitia: treachery.
falsonaria, falsoneria: forgery; making false coin.
falsonarius: a maker of false coin.
famen: a speech.
familia: a set of chess or draughts men.
fanatio: the fawning season in forests.
fancielus: some kind of tenant.
fanula: a fanon, a maniple.
farcinula: a package, a parcel.
fardella, fardellum: a fardel, the quarter, or eighth of a yard land.
fardellarius: the holder of a fardel.
fardellus: a bundle; a fardel; the holder of a fardel.
farinagium: toll of meal or flour.
farricapsium: the hopper of a mill; a bin.
farsatura: stuffing.
farundella: a quarter of an acre.
fascennia, fascina: a bastile, a wooden fort used in besieging a town.
fasianus: a pheasant.
fassus: a faggot.
fausetum: treble; a faucet.
faverca: a forge.
febrimatio: ploughing or digging up land.
feida: a feud.
feira: a fair.
feissa: a strip or stripe (?).
felagus: faithful; a companion.
felo: a felon.
felonia: felony.
felonice: feloniously.
felparia, feltrum: felt.
femoralia: drawers, breeches; cuisses.
fenestra: a window.
fenestreola: a small window.
fengera: fern.
fennatio. See feonatio.
fenissa: a haymaker.
fensura: a fence.
fenticius. See finticius.
feodalis, feudalis: feudal; a vassal.
feodalitas, feoditas: fealty.
feodamentum: feoffment.
feodare: to enfeoff.
feodarius, feodatarius: a feodary, an officer of the court of wards; a feudal tenant by service.
feodelitas: fealty, which is correctly fidelitas.
feodi firma: fee farm.
feoditas: fealty.
feodum: a fee; a fief.
feodum talliatum: fee tail.
feoffamentum: a feoffment, grant of tenements, &c. in fee.
54

