escheccum: a jury, or inquisition; a check.
escheppa. See esceppa.
escheweita: sentinel service done by folk of Bordeaux. (Fr. eschauguette.)
eschina: a chine.
eschippare: to equip; to embark.
esclavus: a slave.
esclenka: a leg of mutton or beef. (Fr. esclanche.)
esclusa: a dam or sluice.
esclusagium: payment for permission to make a sluice.
escomarius: a boatman; a pirate.
escruatio: cleaning (ditches).
escuagium. See scutagium.
escuilliare: to castrate.
escurare: to scour; to cleanse.
esgardia, esgardum: a reward; an award.
asgardiator: an arbiter.
esgardium: an award.
esiamentum: easement.
eskaere, &c. See escaere.
esketor: a robber.
eskiper, gen. eskipri: the skipper of a ship.
eskippa. See esceppa.
eskippare: to equip.
eskirmire: to fence.
esmaelitus: enamelled.
esnamiare: to distrain.
esnecca: a ship.
esnecia, esnaccha, esnechia: primogeniture; the limited right of primogeniture of the eldest coparcener.
espaltare, espeltare. See expeditare.
esperdum: an axe (O.E. sparthe).
esperiolus: a squirrel.
esperkeria: a duty on dried fish in the Channel Islands, consisting of a right of preemption of congers; 2d.
Tournois on every 100 mackerel; 2 sols Tournois on every bushel of fish; and 2d. on every salt conger exported
to Normandy or elsewhere, not in the kingdom of England.
espervarius, esperverius: a sparrow-hawk (accipiter fringillarius).
espicurnantia: the office of spigurnel.
espleta. See expletiae.
espletiamenta. See expletiae.
essaetor: an assayer.
essaia: say, sometimes means fine woolen cloth (serge), sometimes silk. (Fr. soie.)
essarta, essartum. See assartum.
essonia: essoin, excuse for non-appearance at a court baron, &c.
essoniare: to give an excuse; to essoin.
essoniator: an essoiner.
essonium. See essonia.
establiamentum: a settlement.
estallagium. See stallagium.
estallamentum: a mortgage; pawning; an instalment.
estallare: to mortgage; to pawn.
estangnum: a pond (stagnum); a bank or stank; a measure of land less than an acre.
esterlingus: an Easterling; sterling.
estermannus: a pilot.
estintus. See eastintus.
estoverium: estovers, allowance of wood for repairs, or of necessary food and clothes; stover, provender.
estreciare: to make narow; to straiten.
estrepamentum, estrepinamentum: estrepement, injury done to lands by a tenant for life.
estresius: an Easterling.
estuffamentum: stuff; material.
esturare. See escurare.
esturus. See austur.
51

