Marcialis: in the month of March.
marcula: diminutive of marca.
marearchus: an admiral.
maremium: timber.
marescalcia, marescallia, marescaltia: the right of taking fodder for horses; the office of marshal; the
Marshalsea, London; a stable.
marescalcus, marescaldus, marescallus: a farrier; a marshal; a harbinger.
mareschum: a marsh.
maretum: a marsh.
margia: a border, a margin.
Mariale: a book containing Hours of the B. V. M.
marietare: to marry.
marina: the seashore.
marinarius: a seaman, a mariner.
marinellus: a mariner.
mariola: a small image of the Virgin Mary.
marisarchus. See marearchus.
mariscalcia. See marescalcia.
mariscus: a marsh.
maritagium: marriage; a marriage portion; the right of giving in marriage.
maritatio: a gift by the husband to the wife on marriage.
marla: marl.
marlare, marliare: to spread marl over land; to dig marl.
marleputtum: a marlpit.
marlera, marlerium, marletum: a marlpit.
marlia: marl.
marlura: marling.
marna: some clay used in pottery; marl.
marneria: a marlpit; a moat.
marqua: the right of reprisals, marque.
marquezius: a marquis.
marquisia: a marchioness.
marquisius: a marquis.
marra: a moor; an iron tool like a pickaxe.
marscallare: to do a farrier's work.
martellus: a hammer.
marterina pellis: marten fur.
martilogare: to insert in a register of martyrs.
martilogium: a register of martyrs (martyrologium).
martina: a marten (martes foina).
martineta: a kingfisher (alcedo ispida).
Martis dies: Tuesday.
martologium. See martilogium.
martrina, martrix, martro: a marten.
marutia: some additional outwork to a castle.
masagium: a messuage.
masca: a masque.
mascea: a mace.
maserus: a maser, a bowl, often of wood, especially maple.
masnagium: a dwelling-place.
massa: a club; a mass.
massare: to chew; to hammer.
mastinus, mastivus: a mastiff.
mastruca: a cloak of skin, fur inside.
mastrum: a kneading trough.
mastus: a mast.
masuagium. See messuagium.
masuella: a small club.
masura. See mansa.
matare: to mate at chess.
86

