lucina: a gore in a dress.
lucubrum: a lantern.
lucupletare: to enrich.
ludator: a player.
ludricus: a beast of burden.
ludum: a device; a motto.
luigna: a loin.
lumbale, lumbare: a belt, a girdle.
luminarius: a dealer in lights; a chandler.
luminio: lighting.
lunae, dies: Monday. Lunae is also used for Monday by itself, not declined, as--infra Lunae, before Monday;
and the same is true of the names for the other days of the week.
lunarius: a watch dog.
lunda: a bind of eels, i.e. 250; two timbers of skins, i.e. 80.
lundeni: men whose service was on Monday.
lundinarium: a quarter of a virgate.
lunivagus girus: the moon's orbit.
luparius: a wolfhunter.
luplicetum: a hop garden.
lupulatus: made of hops.
lupus: a cutaneous eruption.
lura: a bung.
lurale: a lure.
lusceus: a pike (esox lucius).
lussus, lusus: a brother-in-law.
luta: a lute.
luter: a basin, a laver, a font.
lutrarius: an otter hound.
lutrea: an otter.
lutricius: an otter hound.
luuebona: work done gratuitously.
luvare: a louvre.
luvereticus canis: a wolfhound.
luverus: a louvre.
lymputta: a lime pit.
M.
macarius. See macellarius.
macea: a mace.
macellarius, macerarius: a victualler; a fleshmonger.
maceria: the outer wall of a convent.
machecaria: a meat market.
machecarius. See macellarius.
machecollare: to add machecoulis to a castle.
macia: a mace.
macuellus: a small mace.
macula: mail; silver halfpence.
madera: madder.
madialis: adj. of May.
madius: the month of May.
maeremium, maerennium: timber.
magnagium: a house.
magnalis: great.
magthura: same as mangura (?).
mahemiare: to maim.
mahemium: mayhem, maim.
mahumeria: a mosque.
maialis: adj. of May.
83

