baco: a hog; a salted pig's carcase; a flitch of bacon; a ham.
bactile: a candlestick, esp. of wood.
bacularius: a bachelor.
baculus: a crozier.
badius: bay (horse).
baffa: a flitch of bacon.
baga: a bag or purse.
bagatinus: a small brass Venetian coin, worth in the 17th century about one sixteenth of a penny.
bagea: a badge.
bagus: bay (horse).
bahuda, bahudum: a chest; a trunk, called a barehide in English.
baia: rumour; a bay.
baiardus: a bay horse.
baila, bailium: bail.
bailius, baillivus: a bailiff.
baillia: bailiwick.
baillium: a grant in trust; the "bailey" of a castle.
baius: bay (of a horse).
bajula: a pitcher; the office of bajulus; a nurse.
bajulator: a bearer; a guardian.
bajulus: a bearer; a bailiff.
bajulus aquilae: an officer in the military order of St. John of Jerusalem, the Bailly of the Eagle.
bakeria: a bakehouse.
bala: a bale.
balancea, balancia: a pair of scales.
balasius: a balasse ruby, of a pale colour.
balca: a balk (of land).
balcanifer: the standard-bearer of the Knights Templar.
balcanum: The Templars' standard.
baldacinifer. See balconifer.
baldekinum, baldicum: baudekin, a kind of brocade of silk and gold, originally brought from Bagdad; a
canopy.
baldrea: a baldric.
balducta: a posset.
balengaria, balingarium: a balinger; a barge.
balesius. See balasius.
baleuga. See banleuga.
balidinus: bay (of a horse).
balista: used for a cross-bow, which is properly arcubalista.
balistarius: an arblaster, a cross-bowman.
balla. See ballia, balliva.
ballare: to sweep; to dance.
ballatio: a ballad.
balleuca. See banleuga.
ballia: the "bailey" of a castle. See balliva.
ballium: bail; the "bailey" of a castle; wardship; a grant in trust.
ballius: a bailiff.
balliva, ballivatus: bailiwick; office.
ballivus: a bailiff.
balneare: to bathe.
balneo, miles de: a knight of the Bath.
balneta: some sort of whale.
balus: a bale.
balustraria: loopholes.
bamba: a bed.
bancale, bancarium: a banker, a covering for a bench.
bancum, bancus: a bench.
banda: a band (of soldiers).
bandum: a pennon.
baneale: error for bancale (?), q.v.
15

