bretaschia: a stockade.
bretechia, bretesca: a stockade.
brethachia: a stockade.
brethachiare: to fortify with stockades.
bretnia: a bream.
breve: a writ.
breviarium: a breviary.
brevigerulus: one who carries and serves writs.
brevis: a brief.
brevitor: a writer of writs.
bria: a liquid measure.
brianneum servitium: same as brenagium (?). (Selby Coucher, f. 122b.)
briga: contention; tumult.
brigandinarius: on officer in command of a brigade.
brigata: a brigade.
Brigittensis: a nun of the order of St. Bridget.
broca: a tap. See brocha.
brocagium, broccagium: a broker's hire; brokerage.
brocatus: stitched. See brocha.
broccarius, broccator: a broker.
brocella: a wood.
brocellum: brushwood.
brocha, broccus: an awl; a packing needle; a spit.
brochia: a pitcher.
brochus: a stick of eels, i.e. 25.
broculator: a brewer.
brodiellum: brewet, pottage.
brodium: broth.
broidare, broiderare: to embroider.
brokettus: a brocket, a stag in its second or third year; but in Cl. R. 21 Hen. III. m. 12, the word is applied to
damos, i.e. fallow deer.
brollium: wood, esp. for game.
broncheria: Palm Sunday.
brossus: bruised.
bruarium: heather: heath ground.
brudatus: embroidered.
bruera: heath.
bruilletus: a small coppice.
bruillium. See brollium.
bruisdatus, brusdatus: embroidered.
brullium. See brollium.
brumillus: a bream (abramis brama).
brunda: a stag's horn.
bruneta. See burneta.
brunus: brown.
bruscare: to browse.
bruscia: a wood.
bruscus: brush; broom plant; a beehive.
brussura, brusura: a bruise.
brusua, brusula: browse; brushwood.
bucca, bucia. See bussa.
buccare: to puff.
buccula. See bucla.
bucecarlus: a boatman.
bucellum: a leather bottle.
bucetum: a cattle stall.
bucla: a boss; a buckle.
buclarium: a buckler.
bucula: a buckle.
buculus: the rim of a shield.
22

