gistum: the duty of entertaining the lord when on a journey; yeast.
glandines plumbei: "Anglice hail-hot."
glaneare: to glean.
glasia: ice.
glavea, glavia: a glaive.
gleba: land belonging to a parish church, glebe; a corpse.
glebalis terra: glebe land.
glebaria: turf.
gleniagium: gleaning.
gleniare: to glean.
glis: mud.
gliseria: clayland.
glomellus: a clew.
glomerarius, glomerellus: a commissioner appointed to settle disputes between the scholars of a university and
their servants (?).
glorietta: a gloriet, an upper room in a tower.
glossum: a shrine.
glutum: glue.
gobonatus: embossed.
godetus: a mug.
golda: a drain; a mine (?).
goliarda: buffoonery; a juggler's art.
goliardisare: to act as a goliardus.
goliardus: a buffoon; a juggler.
gonella, gonellus: a gown.
gora. See gara.
gordus: a weir, a weirpool; a gorce.
gorgeria: a gorget.
gorgona: a gargoyle.
gota: a gut, a drain.
gouna: a gown.
grabatum: a couch.
gracemannus: the head of a guild at Lincoln.
gracia: an indulgence.
gradale, graduale: a gradual, or grail, a book containing the musical portion of the mass.
gradiens: passant (heraldic).
graduatus: a graduate, one who has taken a degree in a university.
grafia, graffia: the dignity or territory of a graffio.
graffio: a count, an earl; a reeve.
graffum, grafium: a register, or cartulary; a pen.
grana: scarlet. See granum.
granata: a garnet.
granatarius: a keeper or steward of a granary.
grancia: a grange, esp. a farmhouse belonging to a monastery.
graneta: a garnet.
granetarius. See granatarius.
grangia. See grancia.
grangiarius: the keeper of a grange.
grantum: security. See creantum.
granum: grain; the coccus ilicis and coccus arborum, used in dyeing red.
grapa: a putlog hole.
graphium. See graffium.
gratare: to scratch.
gratarium: a grate.
gratia: an indulgence.
gratiare: to thank.
grava: a grove.
gravetum: a grove.
gravia: a grove. See also grafia.
gremium: the nave of a church.
64

