intronizare: to enthrone.
intrussare: to pack up.
inumbliare: to trim the branches of trees.
invadiare: to mortgage; to pawn.
invadiatio: a mortgage.
invadimoniare: to pledge, to put in pawn.
inventarium: an inventory.
inventio: treasure trove.
inventorium: an inventory.
inveritare: to prove.
investio, investimentum: investiture.
investire: to invest, to give possession.
investitura: investiture.
involutorium: a kerchief.
inwardus: a watchman.
ipoporgium: an andiron.
irrectus: unjust.
irremiscibilis: unpardonable.
irreplegiabilis, irrepleviabilis: irreplevisable, that which ought not to be replevied or delivered on sureties.
irrotulamentum: an enrolment.
irrotulare: to enrol.
irrotulatio: enrolling.
irrugire: to roar.
iter: the circuit, or eyre, of a judge.
iterans justiciarius: a justice in eyre.
iterare: to make a journey; to hold an eyre; to rejudge; to repeat.
iterato: again, repeatedly.
iteratus: repeated.
itineratio: a circuit or eyre.
itura: an alure. See alura.
ivernagium. See hibernagium.
J.
jacens: in abeyance.
jactacula: a hawk's jesses.
jacti: jesses.
jactivus: one who loses by default.
jahones: furze, gorse.
jampnum, jannum: furze, gorse.
jantare: to breakfast.
jardinus: a garden.
jarellum: a barrier.
jarrum: a jar.
jarruyllium: a gutter.
jaula, &c. See gaola, &c.
jauones: furze (?).
jercia: a lamb.
jesa: a gisarme.
jetti: jesses.
jocale: a jewel.
jocarius: a jester.
jocillator: a juggler.
joellum: a jewel.
joppus: a fool.
jornale. See jornata.
jornancia: a day's work.
jornata: a day's work or journey; an acre of land. (Fr. journeau.)
Jovis dies: Thursday.
76

