scindifaber: a bladesmith.
scinditorium: trencher bread.
scindula: shingle for roofing; lath; a blade.
scindularius: a bladesmith.
sciper, sciprus: a skipper, a captain of a ship.
scira. See schira.
scisellum: a chisel.
scisimus: a fur, gris.
scissor: a tailor.
scissorium: a trencher.
scitus: site. For situs.
sclauma: a cloak.
sclavus: a slave.
sclopeta: a gun.
scolpetarius: a musketeer.
sclopetum: a gun; an arquebus.
sclusa: a dam; a sluice.
scochia: a scutcheon.
scolastizare: to study.
sconcha, sconsa: a sconce.
scopellus: a knife; a chisel; a lancet; used for scapilus.
scopeta: a gun.
scoppa: a shop.
scorcium: bark.
scoria: dross; a score.
scorium: a mat.
scortum: escort.
scota: scot; tax.
scotalla, scotallum: a contribution for liquor for forest officers; a feast provided by contribution.
scoticare: to naturalise a man in Scotland.
scotta. See scota.
scottare: to pay scot.
scotum. See scota.
scribania: an office in Guienne, registry.
scrinea, scrineum: a screen.
scrinialis, scriniarius: a scrivener.
scrinium: a shrine.
scriptorium: a writing room.
scrivabile paperum: writing paper.
scrobula: a robe worn by female pilgrims.
scrofa: a sow; a machine for digging at the base of the walls of a fortress.
scrotula: a scroll.
scrutator: an examiner; a watchman.
scrutinium: search; examination.
scrutlanda: land assigned for providing clothes.
scucheo: an escutcheon.
scultetus: a governor, "schout."
scura: a stable.
scurare: to scour.
scurellus: a squirrel.
scurgia: a whip (?).
scuria: a stable.
scurio: a stableman.
scutagium: a tax paid in lieu of military service by those who held lands by knight-service.
scutarius: an esquire; a shield maker.
scutella: a dish; a scuttle; a basket; a coin (?).
scutellarium: a scullery.
scutellarius: a scullion; a monk or other person in charge of crockery and other table things; a dealer in such
ware.
scutifer, scutiger: an esquire.
119

