cornellatus. See carnellare.
cornera, corneria, cornerium: a corner.
cornicallus: a corn on the foot.
corniculare: to blow a horn.
cornisare, cornuare: to blow a horn.
corodium, &c. See corredium.
coronale: a wreath, a crown.
coronamentum: coronation.
coronare: to crown; to make a person a priest; to perform the tonsure.
coronarius: a coroner.
coronatio: coronation.
coronator: a coroner.
coronellus: a colonel.
coronix: a cornice.
corositas: rottenness.
corporale, corporarium: a corporas.
corpus castri: the castle without the surrounding town, &c.
corralius: a currier.
correctarius: a licensed broker.
corrediarius: the holder of a corrody. See corredium.
corredium, corridium: a corrody, money or allowance due by a monastery to the founder for the maintenance
of one of his servants; an allowance of any kind; a livery.
corrigia: a strip of land, leather, &c.; a girdle; a shoe latchet.
corrigiarius: a girdler.
corrodium. See corredium.
cortina: a curtain.
cortinarius: a curtain maker. See cortinetus.
cortinatus: curtained.
cortinetus: a man in charge of the king's tents.
cortis: a courtyard.
cortularium: a farmyard.
corulus: hazel.
corus: a corn measure, perhaps 8 bushels.
corusta: used for chorista.
corvata, corveia: compulsory work done by tenant for lord.
corversarius, corvisarius: a cordwainer; a cobbler.
cosduma: custom.
costa: a rib, a side; a basket; cost.
costamentum: cost.
costera: coast.
costerillum: a flagon.
costillagium: a rent in the Channel Islands.
costiterunt: they cost.
costrellus: a drinking cup, often of wood.
costula: clove (of garlic, &c.).
costuma: custom.
cota: a cot; a tunic; a hat; a sheepcote.
cotagium: a cottage, originally meant the land attached to a cot.
cotarius: a cotter.
cotellus: a cottage.
coterellus: a servile tenant; a bandit.
coteria, coterium: a cottage.
cotmannus: a cottager.
cotsethla: a cottage, a small farmhouse.
cotsethus, cotsetlus, cotsetellus: a cottager.
cotuca: a cloak; coat armour.
couperagium: cooper's work.
coupiator: a woodman.
courba. See corvata.
courearius: a currier.
39

