expeltare. See expeditare.
expenditus: spent.
expensabile vinum: wine usually served.
experquaria. See esperkeria.
explacitare: to plead successfully.
expletiae: esplees; rents; profits.
explicit: it is finished or ended.
expressatum: expressed.
exprexum: for expressum.
expulsare: to expel.
expulsatio: expulsion.
exsartum. See assartum.
exscahetor: an escheator.
extendere: to value lands.
extensor: a valuer.
extenta: extent; valuation.
extermino: to bring without the boundaries.
extimare: for aestimare.
extocare: to grub up.
extolneare: to free from toll.
extrabarrista: an utterbarrister.
extracta, extractum: an estreat, a true extract or copy.
extrahura: a stray.
extraneus: a foreigner, i.e., not a citizen.
extravagantes: certain papal constitutions, not included in Gratian or the Decretals.
extumae: relics.
exulatus: an exile.
exuperare: for exsuperare.
eysiamentum. See aisiamentum.
F.
faber: a smith.
fabrica: a smithy.
facescia: used for facetia.
facitergium: a facewipe, a towel.
factum: a deed, a document.
fagatum: a faggot.
faginum: beech mast.
fagottum: a faggot.
faida: feud, enmity.
faidinus, faiditus: an enemy, an exile, a banished man.
fala: "a somer castel," a wooden tower used at sieges and on board ships; a scaffold.
falanga. See falinga.
falcabilis: fit to mow.
falcare: to mow.
falcatura: a day's work at mowing.
falcidium: a swathe.
falco: a falcon.
falcona: a falcon; a small cannon, 2 1/2 inch bore.
falconaria: the service of supplying falcons.
falda: a fold.
faldae cursus: a sheepwalk.
faldagium: faldage, the right to set up folds.
faldicium: a fold; foldage, foldpenny; payment for folding sheep, or for leave to set up a fold.
faldistorium: an arm-chair; esp. a bishop's throne.
faldum: a fold.
falera: trappings (phalera).
falerarius: a sumpter horse.
53

