Garrienis, Garyenus, Flu.: Yare River, Norfolk.
Garryeni Fluvii ostium: Yarmouth.
Gauinga: Wenge, Bucks.
Gaurouicum: Warwick. See Verouicum.
Gausennae, Gausennis. See Causennae.
Gauelforda: Camelford, Cornwall.
Gedewurda: Jedburgh, Roxburghshire.
Gegenforda: Gainford, Durham.
Geldeforda: Guildford, Surrey.
Genesborwia: Gainsborough, Lincolnshire.
Genunii: People living on the border of Scotland.
Gereseya: Jersey.
Gerewedona: Garendon, Leicestershire.
Gernemua, Gernemutha: Yarmouth, Norfolk.
Gerneria: Guernsey.
Geroldona: Garendon, Leicestershire.
Gersuium: Jersey.
Geuentonae: Chevington, Suffolk.
Geuini: A river in Wales that runs into the River Usk.
Geuissi: West Saxons.
Gipeswica, Gippeuicum: Ipswich, Suffolk.
Girouicum: Jarrow, Durham.
Giruii: Inhabitants of the Fens.
Giruum, Girwa: Jarrow, Durham.
Giuela: Yeovil, Somerset.
Glamorgania, Glamorgantia: Glamorganshire.
Glandelacum: Glendalough, Wicklow, Ireland.
Glannibanta, Glanouenta. See Clanouenta.
Glasbiria: Glasbury, Brecknock.
Glasconia: Glastonbury, Somerset.
Glascouium: Glasgow.
Glascua: Glasgow.
Glascum: Glascwm, Radnorshire.
Glasquum: Glasgow.
Glastincbiria: Glastonbury, Somerset.
Glastonia: Glastonbury.
Glaudiocestra: Gloucester.
Glauorna, Glaworna: Gloucester.
Gleastonia: Glastonbury.
Glenus: River Glen, Northumberland.
Glessoburgus: Glastonbury.
Glestingia, Glestonia: Glastonbury.
Gleuum: Gloucester.
Glocestria, Gloecestra: Gloucester.
Glota: Isle of Arran.
Glota, Glottiana: River Clyde, Scotland.
Gloueceastria, Glouernia, Glowecestria: Gloucester.
Gobannium: Abergavenny, Monmouthshire.
Goccium. See Coccium.
Goderici Castrum: Goodrich Castle, Herefordshire.
Godestoua: Godstow, Oxfordshire.
Godritona: Codrington, Gloucestershire.
Gouheria: Gower, Glamorganshire.
Graecolada: Cricklade, Wilts.
Grampius Mons: The Grampians.
Grangia: Gransha, Down, Ireland.
Granta: River Cam, Cambridgeshire.
Granta, Grantanus Pons: Cambridge.
Grantebreggia: Cambridge, sometimes Cambridgeshire.
Graua: Grovebury, Beds.
25

