Mula: Isle of Mull, west coast of Scotland.
Munekacastra: Newcastle-on-Tyne, Northumberland.
Munemuta: Monmouth.
Munus: River Monnow, which divides Herefordshire from Monmouthshire.
Murevia: Moray, Scotland.
Muridunum. See Moridunum.
Muridunum: Caermarthen.
Murimintum, Muriuindum: Silchester, Hants.
Murionio: In Dorset.
Murotriges. See Durotriges.
Murrevia: Moray, Scotland.
Murthlacum: Murtley, Aberdeen.
Murus: River Vere, Herts.
Murus Picticus: The Picts' Wall. See Hadriani Murus.
Muscomaria: Mossdale Moor, Yorks.
Mussalburgum: Musselburgh, co. Edinburgh.
Mutuantonis: Lewes, Sussex; Whitewalls, Wilts.
Mygensis: Of Mayo, Ireland.
N.
Nabaeus. See Navaeus.
Naeomagus. See Neomagus; Nouiomagus.
Naesbeia: Naseby, Northants.
Nagnata: Sligo, or Limerick.
Nalcua: The same as Galleua.
Nanaeus. See Nauaeus.
Nantouicum: Nantwich, Cheshire.
Nasense Castrum: Naas, Kildare.
Nasi Enei Collegium: Brasenose College, Oxford.
Nauaeus: River Naver, Scotland.
Nauesbia: Naseby, Northants.
Naurum: The Nadder, Wilts; the Naver, Sutherland.
Nautgallum: Walbrook, London.
Nauticus Sinus: Rotherhithe.
Neagora: Newmarket.
Meddercota: Nethercote, Oxfordshire.
Nemedus: Barrymore, near Cork.
Nemetotacio: A town in Cornwall.
Nemus Aquilinum: Elstree, Herts.
Nemus Boreale: North-hall, Herts.
Neomagus: Buckingham. See also Nouiomagus.
Neoportus: Newport, Isle of Wight; Newport, Essex.
Neoportus Paganellicus: Newport Pagnell, Bucks.
Neorus: Lagan Water, Ulster.
Nerigon Insula: Isle of Lewes.
Neslandia: West of Scotland.
Neuarca, Newerca: Newark, Notts.
Nicholia, Nicole: Lincoln.
Nicolesciria: Lincolnshire.
Nidum: Portbury, Somerset; Neath, Glamorganshire.
Nidus: River Nid, Yorks.
Nigera: Blakeney, Norfolk.
Nincolia: Lincoln.
Niomagus. See Nouiomagus.
Nithia: Nidisdale, Scotland.
Niuburia: Newbury, Berks.
Niuicollini: Snowdon Mountain, Caernarvonshire.
Niwebota: Newbottle, Durham.
Niweburia: Newbury, Berks.
38

