Engleschyria: England.
Englewria: England.
Ennabrensis: of Kilfenora, co. Clare.
Eouercon: Abercorn, Scotland.
Eouerwicum: York.
Eouesum: Evesham, Worcestershire.
Eoyrus: River Nore, Ireland.
Epeiacum, Epiacum: Hexham, or Papcastle. See Apiacum.
Epidii: Tribe living in Cantire.
Epidium Insula: Islay.
Epidium promonotorium: Mull of Cantire.
Epocessa: Perhaps Upper Stanton, Herefordshire.
Erchenefelda: Irchingfield, Herefordshire.
Erdingeleya: Ardingley, Sussex.
Erdini: People of Fermanagh, Ireland.
Ergadia: Argyle.
Eripolensis: Of Jerpont, Ossory.
Ermonia: Ormond, Tipperary.
Ernulphi Curia: Eynesbury, Hunts.
Erpeditani. See Erdini.
Esca: River Esk, Dumfries.
Esica. See Aesycha.
Esse Insula: Stourmouth (?), Kent.
Esselega: Ashley.
Essendona: Ashdon, Essex.
Essexa: Essex.
Estantona: Stanton.
Estlega: Astley, Worcestershire.
Estratona: Stratton, Bedfordshire.
Estreia: Eastry, Keny.
Estrindia: East Riding.
Estsexia: Essex.
Esturministra: Sturminster, Dorset.
Ethandunum: Hedddington, Wilts.
Ethelingia: Athelney, Somerset.
Ethona: Nuneaton, Warwickshire.
Etlingeleia: Athelney, Somerset.
Etocetum: Kingsbury, Warwickshire; or Wall, Staffordshire.
Etona: Nuneaton, Warwickshire.
Euania. See Meuania.
Eubonia: Isle of Man. See Mania.
Euenlodus Flu.: River Evenlode, in Oxfordshire.
Euerwica, Euerwika: York.
Eufania: Isle of Man.
Euonium: Dunstaffnage, Argyle.
Eura: River Ure or Yore, Yorks.
Exa Flu.: River Exe, Devonshire.
Exancestria: Exeter.
Excambium Regium: The Royal Exchange, London.
Excestra: Exeter.
Exexa: Essex.
Exoche: Gunfleet, Essex; or Wintertonness, Norfolk.
Exonia: Exeter.
Exosades: Islands off Norfolk or Essex.
Exploratorum Castra: Burgh by Sands, Cumberland.
Extensio. See Exoche.
Eya: Eye, Norfolk.
F.
22

