Virosidum: Ellenborough, Old Carlisle, or Workington, Cumberland.
Viruedrum. See Veruedrum.
Visimonasterium: Westminster.
Visi-Saxones: West Saxons.
Vitrea Insula: Glastonbury.
Vituli Insula: Selsea, Sussex.
Viurus: River Wear.
Viuidin: River Fowey, Cornwall.
Vodiae: People about Cork.
Volantium. See Olenacum.
Voldia: Cotswold, Gloucestershire.
Voliba. See Voluba.
Volitanium: Probably on the Wall of Antonine.
Volsas Sinus: Loch Broom, Ross-shire, or Loch Assynt.
Voluba: Lostwithiel, Tregony, Falmouth, Bodmin, or Grampound, Cornwall.
Volucrum Domus: Fulham, Middlesex.
Voluntii: People of Ulster, Ireland.
Voluntium: Ardglass, Down, Ireland.
Volurtion. See Borcouicum.
Voluicum: Woolwich.
Voran: Caervoran, Northumberland, or Warran, Forfar.
Voreda: Old Penrith, Plumpton Wall, or Kirk Oswald, Cumberland; or Whelp Castle, Westmoreland.
Vosargia: Herm Island in the Channel.
Vusa: River Ouse.
W.
Wabruna: Weybourne, Norfolk.
Wachefelda: Wakefield, Yorks.
Waga, Waia: River Wye; River Wey.
Wekefeldia: Wakefield, Yorks.
Walalega: Whalley, Lancashire.
Walani: Welshmen.
Waldena: Saffron Walden, Essex.
Waldintona: Waldington, Yorks.
Walensis: A Welshman.
Walia: Wales.
Walingforda: Wallingford, Berks.
Walenesteda: Godstone, Surrey.
Walla Londoniarum: London Wall.
Waliscus, Wallanus: A Welshman.
Wallia: Wales.
Walonicus: Welsh.
Waltifordia: Waterford, Ireland.
Wanlokensis: Of Wenlock, Shropshire.
Wanneforda: Wangford, Suffolk.
Wara: Ware, Herts.
Warengeforda: Wallingford, Berks.
Warewella: Wherwell, Hants.
Warle Septem Molarum: Warley, Essex.
Warsopa: Worksop, Notts.
Waruicus: Warwick.
Wasfordia: Wexford, Ireland.
Watafordia: Waterford, Ireland.
Watelega: Wheatley.
Waterfordia: Waterford, Ireland.
Watria: Wavertree, Lancashire.
Wauerlega: Waverley, Hants.
Waya: River Wye; River Wey.
Wdestochia, Wdestoka: Woodstock, Oxfordshire.
57

