de Rubra Manu: Redmayne.
de Rubra Spatha: Rospear, Rooper, Roper.
de Rubro Cliuo: Radcliffe.
de Ruda: Routh.
de Ruella: Ruel, Rule.
Ruffus, Rufus: Le Roux, Le Rus, Rous, Ruff.
de Rugehala: Rugeley, Ruggles.
de Rupe: de la Roche, Roche, Droope, Drope, Rock.
de Rupe Cauardi: de Rochechouard.
de Rupe Forti: Rochfort.
de Rupe Scissa: Cutcliffe.
de Rupella: de la Rochelle, Rokell, Roupell.
de Ruperia. See Rupetra.
de Rupetra: de Rupierre, Rooper, Roper.
de Rupibus, Rupinus: Roche, Rock.
S.
de Sabaudia: Savoy.
de Sacca Villa: Sackville.
de Saceio: de Sace, de Sauce.
de Sacheuilla: Se Sacquenville, Soucheville, Sackville.
de Sacra Fago: Hollebech, Holbeach.
de Sacra Quercu: Holyoak.
de Sacro Bosco: Holywood.
de Sacro Fonte: Holybrook, Holbrook.
Sagittarius: Archer.
de Saio: Say.
de Sackenuilla: Sackville.
de Salceto: Saucey.
de Salchauilla: Salkeld.
de Salicosa Mara: Wilmore.
de Salicosa Vena: Salvein.
de Salso Marisco: Saumarez, Saltmarsh.
de Saltu Capellae: Sacheverel.
de Saltu Lacteo: Melkeley.
Saluagius: Savage.
Sancho: Sankey.
de Sancta Barba or Barbara: Senbarb, Simberb.
de Sancta Clara: St. Clare, Sinclair.
de Sancta Cruce: St. Croix, Cross.
de Sancta Ermina: Armine.
de Sancta Fide: St. Faith, Faith, Fiddes.
de Sancta Geneuefa: Jeneway.
de Sancta Terra: Holyland.
de Sancta Villa: Sent Vile, Sainneville.
de Sancto Albano: St. Alban.
de Sancto Albino: Seyntabyn, St. Aubyn.
de Sancto Alemondo: Salmon.
de Sancto Amando: St. Amand, Samand.
de Sancto Audemaro: St. Omer.
de Sancto Bricio: Brice.
de Sancto Cinerino: Chinnery.
de Sancto Claro: Senclare, Sinclair.
de Sancto Claudo: Clodd, Clode.
de Sancto Crispino: Crispin, Crisp.
de Sancto Dionysio: Dennis.
de Sancto Edmundo: Edmunds.
de Sancto Edolpho: Stydolph.
de Sancto Edwardo: Edwards.
de Sancto Eustacio: Stacey.
16

