de Lato Campo: Bradfield.
de Lato Vado: Bradford.
de Lato Pede: Braidfoot.
Lauremarius: Lorimer.
de Lecha: Leke.
de Lega: Leigh, Lee.
Legatus: Leggatt.
de Leica: Leke.
de Leicestria: Lester.
Leslaeus: Leslie.
Leuchenorius: Lewkin, Lewknor.
de Lexintuna: Lexington.
de Leziniaco: de Lezinan.
de Liberatione: Liverance.
de Lienticuria: de Liancourt.
de Limesia: Limsie.
de Linna: Linne.
de Lisoriis, Lisoris: Lizurs, Lisors.
de Loco Frumenti: Whethamstede.
de Logiis: Lodge.
de Longa Spatha: Longespee.
de Longa Villa: Longueville, Longvill, Longfellow.
de Longo Campo: Longchamp, Longshanks.
de Longo Prato: Longmede.
Lotharingius: Le Loreyne, Lorraine, Lorriner.
Lotharius: Lowther.
de Luceio: Lucy, Lewsey.
Ludouicus: de Lues, Lewis.
de Luera: Lower.
de Lunda: Lund.
de Lupellis: Lovel.
Lupellus: Lovel.
Lupus: Le Loup, Love, Loo, Woolf.
de Lusoriis: Lusher.
de Luxa: De Los.
M.
Macer: Le Meyre.
Macnisius: Mackness.
de Maderiaco: de Mezieres, Measures.
de Magna Pena: de Magne Peine, Moneypenny, Mappin.
de Magna Villa: Mandeville, Mannwille.
de Magno Monte: Grosmount, or Groumount.
Magnus Venator: Grosvenor.
Mainfelinus: Meinfeuin.
de Maino: Maine, Maoun.
de Mala Bissa: de Malebisse, de Malebiche.
de Mala Fide: Mauf√©.
de Mala Herba: Malherbe.
de Mala Opera: Mallop.
de Mala Platea: Malpas.
de Mala Terra: Mauland, Eveland.
de Mala Villa: Melville.
de Malchenceio: Munchensy.
Malconductus: Malduit, Maudit.
Maledoctus: Maudoit.
Maleductus: Malduit, Mauduit.
Malisius: Malis.
de Malis Manibus: Malmaine.
de Malis Operibus: Maloor.
11

