Latin Forms of English Surnames in Great Britain and Ireland
A.
Aba: Abbott.
de Abbacia: Abbess, Dabbs.
de Abbaneio: Abney.
Abbas: Abbott.
de Abrincis: D'Avranches.
Acutus: Hawkwood.
de Adurni Portu: Etherington.
de Agnellis: Agnew, Dagnall.
de Agnis: Aignes, Ains.
de Aillio: D'Aile, Alley.
Ala Campi: Wingfield.
de Alba Mara, de Alba Marla: Albemarle, Aumarle.
de Albeneio: D'Aubeney, Albiney, Albeney.
Albericus, Albrea, Albraeus: Awbrey.
de Albineio, Albiniaco: D'Aubeney, Albiney, Dolben.
de Albo Monasterio: Blancmuster, Whitchurch.
Albus: White.
de Aldedelega: Audley.
de Aldithelega, Alditheleia: Audley.
Alec: Herring.
de Alemania: Dalmaine.
Alemannicus: Allman.
Alesius: Alane.
de Alneto: Dawnay, Dannay, Dennett.
de Alno: Daunay.
Alselinus: Ansell, Ancell.
de Alta Ripa: de Hauterive, Dawtrey, Daltry, Hawtrey.
de Alta Riva. See de Alta Ripa.
de Alta Villa: De Hauteville.
de Alto Menillo: de Hautmesnil.
de Amblia: De Amblie, Hamley.
Anastasius: Anstis.
de Ancariis: Dancer.
de Andeuilla: Hanwell.
Anclicus: Inglis, England.
de Angulis: Angell.
de Angulo: del Angle, atte Cornere.
in Angulo: atte Noke.
de Ansa: Daunce.
de Apibus: Bee, Bye (?).
Apotecarius: Lespicer, Spicer.
Apparitor: Sumner.
de Aqua Blanca: Egeblaunch, Aygueblanche.
de Aqua Frisca: Freshwater.
Aquapontanus: Bridgwater.
de Aquila: Eagle, D'Eagles, Diggles.
Arbalistarius: Arblaster, Alabaster.
Archidiaconus: Archdeacon, Arcedeckne.
de Archis, Arcis: D'Arques, Arch, Dark.
de Arcla: Harcla, Argles.
Arcuarius: Archer, Larcher.
de Arcubus: de Arches, Bowes.
de Arenis: Darens, Darayns, Sandes.
de Argentomo: Argentoune.
de Arida Villa: Dryton, Dryden.
de Ariete: Herriott.
1

