de Benefactis: Benfield.
de Beneuolis: Benlows.
Bercarius: Le Bercher, Barker.
Bercator: Barker.
Berengarius: Barringer.
de Bereuilla: de Berville, Burfield, Berewell.
de Berneriis: Berners.
de Beuerlaco: Beverley.
Bituricensis: de Bourges.
de Blanco Pane: Whitbread.
de Blauia: de Blaye.
de Blithoduno: Blyton.
de Blosseuilla, Blosteuilla: Blovile, Blofield.
de Bloys: Blew, Bligh.
de Blundeuilla: Blundeville, Blomfield.
Blundus: Le Blond, Blundel, Blount. In the case of a lady, the feminine Blunda is used.
de Boceo: de Bocy.
de Boeuilla: Bovill.
de Bologna: Bullen.
de Bona Villa: Bonville.
de Bono Fassato: Goodrick.
Bononius: Boleyn.
de Boonia: de Bohun.
de Borgeis: Burges.
Borlasius: Borlace.
de Bortano: Burton.
de Bosco: Boys, Boyce, Busk, Wood.
de Bosco Arso: Brentwood.
de Bosco Roardi: Borhard.
de Boseuilla: Boswell.
de Botellis: Butler.
de Boterellis: Botreaux, Botrel.
de Boularia: de Bollers, Buller.
de Bouis Villa: Bovill.
de Braiosa: de Braose, Brewis, Brewhouse.
Brito: Le Bretun.
de Broilleio: de Bruilly, Briley.
de Brueria: Bryer, Briewer, Brewer.
Brunelli: Burnell.
Brunus: Le Brun, Brown.
de Bucca: Buck.
de Bucca Uncta: de Bouchaine, Buccointe, Budgen.
de Bucis: de Buces, Bouche, Bush.
Budellus: de Buelles, Boyle.
de Buesuilla: Bouville, Bousville, Boseville, Bousfield.
de Bulemara: Bulmer.
de Buliaco: Buisly, Builly.
de Burco: de Burgh.
Burgensis: Burges.
de Burgo: de Burgh, Burke, Bourke.
de Burgo Charo: Bourchier.
Burgundiensis: de Bourgogne, Bourgoyne, Burgon.
de Burnauilla: Bernwell, Barnwell.
de Burtana: Burton.
de Bussa Villa: de Boseville, Beuzefille, Boscherville.
C.
de Cabanisio: de Chalbeneys.
de Cadomo: de Caen, Caine.
de Cadurcis: de Chaorces, Chaworth.
3

